1  * *B  * *   * *  * * 
*  *    *  *  * 3*  *  
* *       * * *    *   * 
2  * *  * *   * *  * * 
  4  *     0     *       
* *    *   * * *    *   * 
8    **        5      
* 6     *  * 9     *  
*  *  7*  *  *  *  *  *  
*      *  *      *  A
